11111115111111
111111  111111
11          11
11 111  111 11
11 111  111 11
11 111  111 11
              
11111111111111
11111111111111
11111111111111
11111111111111
11111111111111
