11111111111111
11 1 1 1 1 111
1           11
11       2 111
            11
11         111
1           11
11         111
1           11
11 1 1 1 1 111
11111111111111
11111111111111
