1111111111 111
1111111111 111
1111111112 111
1111111111 111
11111111   33 
11111111 11111
11111111 11111
11111111411111
11111111 11111
111111   11111
111111 1111111
111111 1111111
