1111111 111111
1111111 111111
1111111 111111
1111111 111111
1111111 111111
1111111 111111
1111111       
11111111111111
11111111111111
11111111111111
11111111111111
11111111111111
