11111111111111
11111111111111
111          1
111        5 1
111          1
111          1
           2 1
111          1
111          1
111          1
11111111111111
11111111111111
