11111111111111
11111111111111
11111111111111
            11
11111       11
   11    5  11
11111       11
11111    2  11
11111       11
  511       11
11111       11
11111111111111
