11111111111111
11111111111111
11112  112  11
11111121111211
111 2111111111
111 1111111111
   211111112  
111 1111111111
111 2111111111
11111121111211
11112  112  11
11111111111111
