11111111111111
11111111111111
1111         1
1111 111111  1
1111 111111  1
1111 15      1
1    111111111
         4  4 
1       111 11
11111   111 11
11111111115 11
11111111111111
