11111111111111
11111111111111
11111111111111
11111111111111
111111111  33 
11111111   111
11111111 11111
  111111 11111
1  1     11111
11   111111111
111 8111111111
11111111111111
