111111 1111111
111111 1111111
111111 1111111
111111  111111
1111111 111111
1111111 111111
1111112       
1111111 111111
11111114111111
1111111 111111
1111111 111111
1111111 111111
