11111111111111
1       111111
1       111111
111111  111111
111111  111111
111111  111111
111111  111111 
111112        
11111111113111
11111111113111
1111111111 111
1111111111 111
