11111111111111
11111111 61111
1111     11111
1           4 
          1111
111   111   4 
11111  1111111
111111 1111111
111111 4  1111
11111111    3 
11111111111111
11111111111111
